%%%%%%%%%%%%%%%%%%%%%%%%%%%%%%%%%%%%%%%%%%%%%%%%%%%%%%%%%%%%%%%%%%%%%
% %%%                                             %         %   %   %
% % % % %%%%%%%%%%%%%%%%%%%%%%%%%%%%%%%%%%%%%%%%%%% % %% %% % % % % %
% % % % %                                           % %% %% % % % % %
% % % % %                                           % %% %% % % % % %
% % % % %                                           % %% %% % % % % %
% % % % %                                           % %% %% % % % % %
% % % % % %%%%%%%%%%%%%%%%%%%%% %%%%%%%%%%%%%%%%%%% % %% %% % % % % %
% % % % % %%%%%%%%                           %%%%%% % %% %% % % % % %
% % % % % %%%%%%%%%%%%%%%%%%%%% %%%%%%%%%%%%%%%%%%% % %% %% % % % % %
% % % % %                                           % %% %% % % % % %
% % % % %                                           % %% %% % % % % %
% % % % %                                           % %% %% % % % % %
% % % % %                                           % %% %% % % % % %
% % % % % %%%%%%%%%%%%%%%%%%%%% %%%%%%%%%%%%%%%%%%% % %% %% % % % % %
% % % % % %%%%%%%%                          %%%%%%% % %% %% % % % % %
% % % % % %%%%%%%%%%%%%%%%%%%%% %%%%%%%%%%%%%%%%%%% % %% %% % % % % %
% % % % % %%%%%%%%                          %%%%%%% % %% %% % % % % %
% % % % % %%%%%%%%%%%%%%%%%%%%% %%%%%%%%%%%%%%%%%%% % %% %% % % % % %
% % % % %                                           % %% %% % % % % %
% % % % %                                           % %% %% % % % % %
% % % % %                                           % %% %% % % % % %
% % % %                                             % %% %% % % % % %
%.% %%% %%%%%%%%%%%%%%%%%%%%%%%%%%%%%%%%%%%%%%%%%%%%%    %%       %P%
%%%%%%%%%%%%%%%%%%%%%%%%%%%%%%%%%%%%%%%%%%%%%%%%%%%%%%%%%%%%%%%%%%%%%