%%%%%%%%%%%%%%%%%%%%%%%
%          %%%%%%%%%%%%
% %%%%%%%% %          %
% %      % % %%%%%%%% %
% % %%%% % % %%%%%%%% %
% % %%%% % % %%%%%%%% %
% % %%%% % % %%%%%%%% %
% % %%%% % % %%%%%%%% %
% % %%%%  P           %
% % %%%%%% %%%%%%%%%%%%
% %%%%%%%% %%%%%%%%%%%%
%     %%              %
%%%  %%%%% %%%%%%%%%% %
%%%   %%%% %%%%%%%%%% %
%.  %%%%%% %          %
%%%%%%%%%%%%%%%%%%%%%%%