%%%%%%%%%%%%%%%%%%%
%                 %
%%%%%%   %        %
%        %        %
%        %P       %
%   %%%%%%%%%%%%  %
%           %     %
% %%%%%%    %   % %
%.%    %        % %
%%%%%%%%%%%%%%%%%%%