%%%%%%%%%%%%%%%%%%%%%%%%%%%%%%
%                            %
% % %%%%%%%%%%%%%%%%%%%%%%%% %
% %                        % %
% %%%%%%%%%%%%%%%%%%%%%%%% % %
% %    % %   %   %   %   % % %
% % %% % % % % % % % % % % % %
% % %% % % % % % % % % % % % %
% % %% % % % % % % % % % % % %
% % %%     %   %   %   %     % 
% % %%%%%%%%%%%%%%%%%%%%%%%% %
% %                       P% %
% %%%%%%%%%%%%%%%%%%%%%%%%%% %
%.                           %
%%%%%%%%%%%%%%%%%%%%%%%%%%%%%%