%%%%%%%%%%%%%%%%%%%%%%%%%%%%%%%%%%%%%%%%%%%%%%%%%%%%%%%%%%%%%%%%%%%%%
%   %                                                       %   %   %
% % % % %%%%%%%%%%%%%%%%%%%%%%%%%%%%%%%%%%%%%%%%%%% % %% %% % % % % %
% % % % %                                           % %% %% % % % % %
% % % % %                                           % %% %% % % % % %
% % % % %                                           % %% %% % % % % %
% % % % %                                           % %% %% % % % % %
% % % % % %%%%%%%%%%%%%%%%%%%%% %%%%%%%%%%%%%%%%%%% % %% %% % % % % %
% % % % % %%%%%%%%                           %%%%%% % %% %% % % % % %
% % % % % %%%%%%%%%%%%%%%%%%%%% %%%%%%%%%%%%%%%%%%% % %% %% % % % % %
% % % % %                                           % %% %% % % % % %
% % % % %                                           % %% %% % % % % %
% % % % %                                           % %% %% % % % % %
% % % % %                                           % %% %% % % % % %
% % % % % %%%%%%%%%%%%%%%%%%%%% %%%%%%%%%%%%%%%%%%% % %% %% % % % % %
% % % % % %%%%%%%%                          %%%%%%% % %% %% % % % % %
% % % % % %%%%%%%%%%%%%%%%%%%%% %%%%%%%%%%%%%%%%%%% % %% %% % % % % %
% % % % % %%%%%%%%                          %%%%%%% % %% %% % % % % %
% % % % % %%%%%%%%%%%%%%%%%%%%% %%%%%%%%%%%%%%%%%%% % %% %% % % % % %
% % % % %                                           % %% %% % % % % %
% % % % %                                           % %% %% % % % % %
% % % % %                                           % %% %% % % % % %
%                                                   % %% %% % % % % %
%.% %%% %%%%%%%%%%%%%%%%%%%%%%%%%%%%%%%%%%%%%%%%%%%%%    %%       %P%
%%%%%%%%%%%%%%%%%%%%%%%%%%%%%%%%%%%%%%%%%%%%%%%%%%%%%%%%%%%%%%%%%%%%%