%%%%%%%%%%%%%%%%%%%%%%%%%%%%%%%%%%%%%%%%%%
%                                       P%
% %%%%%%%%%%%%%%%%%  %%%%%%%%%% %%%%%%%%%%
% %      %%%%%%%%%  %%%%%%%%%%%          %
% %%%%%%       %%  %%%%%%%%%%%%%%%%%%%%% %
%        %%%%%%%%              %%%%%%%%% %
%%%%%%%%%%%%%%%%%%%%%%%%%%%%%% %%%%%%%%% %
%.                                       %
%%%%%%%%%%%%%%%%%%%%%%%%%%%%%%%%%%%%%%%%%%