%%%%%%%%%%%%%%%%%%%%%%
%                    %
% %%%%%%%%%%%%%%%%%% %
%          %P        %
%%%%%%%%%% %%%%%%%%%%%
%        %           %
% %%%%%% %%%%%%%%%%% %
% %                  %
%.% %% %% %% %% %% %%%
%%%%%%%%%%%%%%%%%%%%%%