%%%%%%%%%%%%%%%%%%%%
%    %%%%%%        %
% %%        %%%%%% %
% %%%%%%%%%%%%   % %
%         %% % % % %
%%%%%%%  .%% % % % %
%%%%%%%%%%%% % % % %
%              %   %
% % %%%%%%%%%%%%%% %
%P%                %
%%%%%%%%%%%%%%%%%%%%