%%%%%%%%%%%%%%%%%%%%%%%%%%%%%%%%%%%%%%%%%%%%%%%%%%%%%%%%%%%%
%                                                          %
% %%%%%%%%%%%%%%%%  %%%%%%%%%%%%%%%%%%%%%%%%%%%%%%%%%%%%%%P%                                                    
% %                                                      %%%
% % % %%%%%%%%%%%%%%%%%%%%%%%%%%%%%%%%%%%%%%%%%%%%%%%%%    %                                                
% % %                                                 % %% %  
% % %%%%%%%%%%%%%%%%%%%%%%%%%%%%%%%%%%%%%%%%   %      % %% %
% % %                                      %   %      % %% %
% % % %%%%%%%%%%%%%%%%%%%%%%%%%%%%%%%%%%%% %   %      %%%% %
% % % %                                  % %   %           %
% % % % %%%%%%%%%%%%%%%%%%%%%%%%%%%%%%%%%%     %%      %   %                           
% % % %                                    %   %% %  % %   %
% % % %%%%%%%%%%%%%%%%%%%%%%%%%%%%%%%%%%%% % % %% %  % %   %                                  
% % % % %   %      % %     %   %   %     % % % %% %  % %   %
% % % % % % % %  % % %     % % % % % % % % % % %% %  %     %
% % % % % % % %  % %       % % % % % % % % % % %% %  %     %
% % % % % % % %  % % %%%%% % % % % % % % % % % %% %        %
% % % % % % % %  %   %   % % % % % % % % % % % %% %%%%%%   %
% % % % % % % %  %   % % % % % % % % % % % % % %% %        %
% % % % % % % %      % % % % % % % % % % % % % %% % %%%%%  %
% % % % % % % %%%%%% % % % % % % % % % % % % % %% %        %
% % % % % % % %      % % % % % % % % % % % % % %% %%%%%%   %
% % %%% % % % % %%%%%% % % % % % % % % % % % % %% %        %
% % %   % % % %      % % % % % % % % % % % % %  % % %%%%%  %
% % %   % % % %%%%%% % % % % % % % % % % % % %  % %        %
% % %   % % % %      % % % % % % % % % % % % %  % %%%%%%   %
% % %   % % % % %%%%%% % % % % % % % % % % % %  % %        %
% % %   % % % %      % % % % % % % % % % % % %  % % %%%%%  %
% % %   % % % %%%%%% % % % % % % % % % % %   %             %
% % %   % % % %      % % % % % % % % % % %  %%%%%%%%%%%    %
% % %   % % % % %%%%%% % % % % % % % % %    %         %    %
% % %     %          % % %   %   %   %      % %%% %%% %    %
% % %%%%%%%%%%%%%%%%%% % %%%%%%%%%%%%%%%%%% %     % %%%%   %
% %                    %                    %     %    %   %
% %%%%%%%%%%%%%%%%%%%  % %%%%%%%%%%%%%%%%%%%%     %%%%%%%%%%                                                
%                      %                                  .%
%%%%%%%%%%%%%%%%%%%%%%%%%%%%%%%%%%%%%%%%%%%%%%%%%%%%%%%%%%%%