%%%%%%%%%%%%%%%%%%%%%%%%%%
%                        %
%%%P    %%%        % %%  %
%  %%%%%%%%%%%%%%%%% % % %
%                        %
% %%%%%%%%%%%%%%%% %%%%% %
%.                       %
%%%%%%%%%%%%%%%%%%%%%%%%%%