%%%%%%%%%%%%%%%%%%%%
%                  %
% % %% %% %% %% %% %
% %                %
% %%%% %% %% %% %% %
% % %              %
% % %% %% %% %% %% %
% % %% %%       %% %
% % %% %% %% %% %% %
% % %% %%       %% %
% % %% %% %% %%%%% %
% %            P%% %
% % %% %% %% %% %% %
%.%               %%
%%%%%%%%%%%%%%%%%%%%