%%%%%%%%%%%%%%%%%%%%%%%%%%%%%%%%%%%%%%%%%%%%%%%%%%
%                 %  %%%%%%%                     %
% %%%%%% %%%%%%%% %% %%%%%%% %%%%%%  %% %%%% %%% %
%                 %%         %%%%%  %%%          %
% %%%%%% %% %%%%%%%%%%%%%%%%%%%%%  %%%%  %%% %%%%%
%        %%  %%%               %  %%%%  %%%% %%%%%
%%%%%%%% %%%  %%%%%%%%%%%%%%%%%  %%%%  %%%%% %%%%%
%% %%%%% %%%%  %%%%%%%%%%%%%%%  %%%%% %%%%   %%%%%
%%                                           %%%%%
%%%%%%%% %%%%%%%%%%%%%%%%%%%%%%%%%%%%%%%%%%% %%%%%
%%%%%%%% %%                         %%%%%%%% %%%%%
%%%%%%%% %% %%%%%%%%      %%%%%%%%% %%%%%%%% %%%%%
            %                    P%              
%%%% %%% %% %%%%%%%%%%%%%%%%%%%%%%% %%%%%%%% %%%%%
%%%% %%% %%                         %%%%%%%% %%%%%
%%%% %%% %%%%%%%%%%%%%%%%%%%%%%%%%%%%%%%%%%% %%%%%
%                    %%%%%%%%%%%%%%%%%%%%%%% %%% %
% %% %%% %%%%%%%%%%%                      %% %%% %
% %% %%% %%%%%%%%%%% %%%%%%%%%% %%%%%%%%% %% %%% %
% %% %%%             %%%%%%%%%% %%%%%%%%% %% %%% %
% %% %%% % %%%%%%%%%%%%%%%%%%%% %%%%%%%%% %% %%% %
% %% %%% % %%%%%%%%%%%%%%%%%%%% %%%%%%%%% %% %%% %
% %% %%% %                                %% %%% %
% %%%%%%%%%%%%%%%%%%%%%%%%%%%%%%%%%%%%%%%%%% %%% %
%.                                               %
%%%%%%%%%%%%%%%%%%%%%%%%%%%%%%%%%%%%%%%%%%%%%%%%%%