%%%%%%%%%%%%%%%%%%%%
%    %%%%%%        %
% %%        %%%%%% %
% %%%%%%%%%%%%   % %
%         %% % % % %
%%%%%%%  P%% % % % %
%%%%%%%%%%%% % % % %
%              %   %
% % %%%%%%%%%%%%%% %
%.%                %
%%%%%%%%%%%%%%%%%%%%