%%%%%%%%%%%%%%%%%%%%%
%%%%   %            %
%%%  %  % % %% %%%% %
%%  %%%  %% %% %P%% %
%  %%%%%  %%%% % %% %
%.%%%%%%%      %    %
%%%%%%%%%%%%%%%%%%%%%