%%%%%%%%%%%%%%%%%%%%%%%%%%%%%%%%%%%%%%%%%%%%%%%%%%%%%%%%%%%%
%                                                          %
% %%%%%%%%%%%%%%% %%%%%%%%%%%%%%%%%%%%%%%%%%%%%%%%%%%%%%%% %
% % %%%%%%%%      %%                %%%%%%%%%%%%%%%%%%%%%% %
% % %%%%%%%% %%%% %% %%%%%%%%%%%%%% %%%%%%%%%%%%%%%%%%%%%% %
% % %  %   % %%%% %% %            % %                      %
% % % %% % % %%%% %% % %%%%%%%%%% % % %%%%%%%%%%%%%%%%%%%%%%
% % % %% % % %%%% %% % %        % % %                %%%%% %
% % %    % % %%%% %% % % %%%%%% % % %%%%%%%%%%%%%%%% %%%%% %
% % %%%%%% % %%%% %% % % % %% % % % %                %%%%% %
% % %      % %%%% %% % % % %% % % % % %%%%%%%%%%%%%% %%%%% %
% % % %%%%%% %%%% %% % % % %% % % % %              % %%%%% %
% % % %%%%   %%%% %% % % % %% % % % %%%%%%%%%%%%%% % %%%%% %
% % % %%%%%% %%%% %% % % % %% % % % %              % %%%%% %
% % %      % %%%% %% % % % %% % % % % %%%%%%%%%%%%%% %%%%% %
% % %%%%%% % %%%% %% % % % %% % % % % %%    %   %%%% %%%%% %
% % %%%%   % %%%% %% % % % %% % % % % %% %% %%% %%%%       %
% % %%%%%% % %%%% %% % % % %% % % % % %% %% %%% %%%% %%%%%%%
% % %      % %%%% %% % % % %% % % % % %% %% %%% %%%% %%%%%%%
% % % %%%%%% %%%% %% % % %      % % % %% %% %%% %%%% %%%%%%%
% % % % %%%% %%%% %% % % %%%%%%%% % % %% %% %%%      %%%%%%%
% % %%%%%% % %%%% %% % %          % % %% %% %%%%%%%% %%%%%%%
% % %%%%%% % %%%% %% % %%%%%%%%%%%% % %% %% %%%%%%%% %%%%%%%
% %        % %%%% %% %              %              % %%%%%%%
% % %%%%%%%% %%%% %% %%%%%%%%%%%%%%%%%%%%%%%%%%%%%%% %%%%%%%
%P%          %%%%                      %%%%%%%%%%%%% %%%%%%%
%%%%%%%%%%%%%%%%%%%%%%%%%%%%%%%%%%%%%% %%%%%%%%%%%%% %%%%%%%
%%                                                      %%%%
%% %%%%% %%%%%%%%%%%%%%%%%%%%%%%%%%%%%%%%%%%%%%% %%%%%%%%%%%
%% %                          %%%%%%%%           % %%% %%% %
%% % % %%%%%%%%%%%%%%%%%%%%% %%%%%%%%%%%%%%%%%%% % %   %   %
%% % % %                                         % % % % % %
%% % % % %%%%%%%%% %%%%%%%%% %%%%%%%%%%% %%%%%%%%% % % % % %
%% % % % %%%%%%%                           %%%%%%% % % % % %
%% % %   %%%%%%%%%%%%%%%%%%%%%%%%%%%%%%%%%%%%%%%%% % %   % %
%. % %%%                                             %%% % %
%%%%%%%%%%%%%%%%%%%%%%%%%%%%%%%%%%%%%%%%%%%%%%%%%%%%%%%%%%%%